##########
#    #   #
#    #   #
#    #   #
#        #
#        #
#        #
##########
